111111111
1E1000001
110001001
101001001
1P000C001
111111111
