1111111111111
10010000C0001
1110011111001
1P1011E00C001
1111111111111
