111111111111111111111111111111111
1P0C00000000000000000000000000E01
111111111111111111111111111111111
